############################
#................X.........#
#..........................#
#..........................#
#..........................#
#..............X.X.........#
#..........................#
#..........................#
#..........................#
############################
